01 01 01 01 01 01 01 01 01
01 03 03 03 03 03 03 03 01
01 03 03 03 03 03 03 03 01
01 03 03 03 03 03 03 03 01
02 03 03 03 03 03 03 03 01
01 01 01 01 01 01 01 01 01